N N W W W W W W
W W W . . . B W
W . . . . . . W
W . . . . . . W
W . P . . . . W
W . . . . . . W
W . . S . . . W
W . . . . . . W
W W W W W W W W